"State","District","Sprinkler","Drip Irrigation","Open channel","Under ground channel","Others","Total"
"ANDHRA PRADESH","ADILABAD",20,0,48,0,0,68
"ANDHRA PRADESH","ANANTHAPUR",1,1,333,226,0,561
"ANDHRA PRADESH","CHITTOOR",1072,527,19343,7452,539,28933
"ANDHRA PRADESH","CUDDAPAH",193,76,18691,1277,43,20280
"ANDHRA PRADESH","EAST GODAVARI",14,24,4011,3,35,4087
"ANDHRA PRADESH","GUNTUR",20,29,993,587,825,2454
"ANDHRA PRADESH","KARIMNAGAR",15,0,168,13,142,338
"ANDHRA PRADESH","KHAMMAM",14,15,972,109,2,1112
"ANDHRA PRADESH","KRISHNA",14,7,907,16,11,955
"ANDHRA PRADESH","KURNOOL",53,44,2091,303,86,2577
"ANDHRA PRADESH","MEDAK",0,2,130,345,62,539
"ANDHRA PRADESH","NALGONDA",26,1,12,9,14,62
"ANDHRA PRADESH","NELLORE",3,8,315,5,2,333
"ANDHRA PRADESH","NIZAMABAD",0,0,4,6,0,10
"ANDHRA PRADESH","PRAKASAM",10,3,1199,430,52,1694
"ANDHRA PRADESH","RANGAREDDY",179,37,1091,108,138,1553
"ANDHRA PRADESH","SRIKAKULAM",5,4,47,1,0,57
"ANDHRA PRADESH","VISAKHAPATNAM",1,0,7,0,0,8
"ANDHRA PRADESH","WARANGAL",71,12,570,133,1,787
"ANDHRA PRADESH","WEST GODAVARI",507,110,18013,2311,133,21074
"ARUNACHAL PRADESH","PAPUMPARE",0,0,3,0,0,3
"ASSAM","BARPETA",0,3,8,0,0,11
"ASSAM","BONGAIGAON",0,0,0,17,0,17
"ASSAM","CACHAR",0,0,2,0,0,2
"ASSAM","DARRANG",0,1,25,82,23,131
"ASSAM","DHEMAJI",2,1,0,12,0,15
"ASSAM","DHUBRI",0,0,13,3,0,16
"ASSAM","DIBRUGARH",1,0,0,8,0,9
"ASSAM","GOALPARA",0,0,11,18,0,29
"ASSAM","GOLAGHAT",3,0,12,3,0,18
"ASSAM","HAILAKANDI",0,0,0,7,0,7
"ASSAM","JORHAT",11,2,37,44,7,101
"ASSAM","KAMRUP",16,3,11,3,0,33
"ASSAM","KARBIANGLONG",2,0,1,0,0,3
"ASSAM","KARIMGANJ",2,0,0,9,0,11
"ASSAM","KOKRAJHAR",0,0,0,4,0,4
"ASSAM","LAKHIMPUR",0,3,9,83,0,95
"ASSAM","MORIGAON",0,0,2,7,0,9
"ASSAM","NAGOAN",8,5,9,0,0,22
"ASSAM","NALBARI",4,0,13,15,12,44
"ASSAM","NC HILLS",1,0,0,0,0,1
"ASSAM","SIBSAGAR",0,0,5,13,3,21
"ASSAM","SONITPUR",2,0,3,3,0,8
"ASSAM","TINSUKIA",7,0,1,145,0,153
"BIHAR","AURANGABAD",10,2,70,5,9,96
"BIHAR","BANKA",0,0,3,0,0,3
"BIHAR","BEGUSARAI",1,1,191,59,0,252
"BIHAR","BHAGALPUR",12,14,114,15,0,155
"BIHAR","BHOJPUR",30,5,87,16,4,142
"BIHAR","BUXAR",6,2,126,19,2,155
"BIHAR","DARBHANGA",7,1,192,13,3,216
"BIHAR","EAST CHAMPARAN",14,1,224,40,3,282
"BIHAR","GAYA",0,0,47,10,2,59
"BIHAR","GOPAALGANJ",4,14,25,12,1,56
"BIHAR","JAMUI",0,0,3,0,0,3
"BIHAR","JEHANABAD",6,1,27,2,0,36
"BIHAR","KAIMUR (BHABUA)",23,4,108,12,0,147
"BIHAR","KATIHAR",1,4,23,39,0,67
"BIHAR","KHAGARIA",1,1,118,6,0,126
"BIHAR","KISHANGANJ",0,0,8,2,0,10
"BIHAR","LAKHISARAI",5,0,20,20,0,45
"BIHAR","MADHEPURA",1,0,32,1,1,35
"BIHAR","MADHUBANI",31,3,575,14,19,642
"BIHAR","MUNGER",0,0,2,0,0,2
"BIHAR","MUZAFFARPUR",18,5,212,10,4,249
"BIHAR","NALANDA",14,9,145,18,2,188
"BIHAR","NAWADA",3,10,121,14,2,150
"BIHAR","PATNA",32,6,224,40,6,308
"BIHAR","PURNIA",1,0,2,0,0,3
"BIHAR","ROHTAS(SASARAM)",2,5,79,2,0,88
"BIHAR","SAHARSA",0,0,15,0,0,15
"BIHAR","SAMASTIPUR",17,7,207,22,4,257
"BIHAR","SARAN",7,0,129,15,0,151
"BIHAR","SHEKHPURA",1,2,125,12,1,141
"BIHAR","SHEOHAR",0,0,19,0,0,19
"BIHAR","SITAMARHI",1,119,956,39,733,1848
"BIHAR","SIWAN",12,0,89,3,1,105
"BIHAR","SUPAUL",0,4,38,0,0,42
"BIHAR","VAISHALI",3,23,28,13,3,70
"BIHAR","WEST CHAMPARAN",2,2,20,3,0,27
"CHANDIGARH","UT CHANDIGARH",0,0,18,39,0,57
"CHHATTISGARH","BASTER",1,0,2,1,0,4
"CHHATTISGARH","BILASPUR",884,5,402,0,101,1392
"CHHATTISGARH","DANTEWADA",0,0,3,0,0,3
"CHHATTISGARH","DHAMTARI",0,0,8,0,0,8
"CHHATTISGARH","DURG",9,4,161,0,16,190
"CHHATTISGARH","JANJGIR-CHAMPA",1639,2,681,1,358,2681
"CHHATTISGARH","JASHPUR",0,0,1,0,0,1
"CHHATTISGARH","KANKER",0,0,6,0,0,6
"CHHATTISGARH","KORIA",2,0,2,0,0,4
"CHHATTISGARH","KVARDHA",11,1,28,0,30,70
"CHHATTISGARH","MAHASAMUND",0,0,2,0,2,4
"CHHATTISGARH","RAIGARH",98,3,514,0,27,642
"CHHATTISGARH","RAIPUR",2,1,87,23,21,134
"CHHATTISGARH","RAJNANDGAON",1,0,12,1,3,17
"CHHATTISGARH","SURGUJA",4,0,65,2,0,71
"DELHI","MAHRAULI",36,4,365,68,3,476
"DELHI","NAJAFGARH",28,4,81,54,2,169
"GOA","NORTH GOA",10,1,34,3,9,57
"GOA","SOUTH GOA",0,1,2,0,0,3
"GUJARAT","AHMEDABAD",64,20,2814,3531,257,6686
"GUJARAT","AMRELI",0,0,5559,0,0,5559
"GUJARAT","ANAND",32,6,125,2160,22,2345
"GUJARAT","BANASKANTHA",95,35,13269,7153,591,21143
"GUJARAT","BHARUCH",2,0,69,135,1,207
"GUJARAT","BHAVNAGAR",0,0,0,4,0,4
"GUJARAT","DANG",0,0,0,1,0,1
"GUJARAT","GANDHINAGAR",4,0,1059,6911,16,7990
"GUJARAT","JUNAGADH",81,17,7119,2,2,7221
"GUJARAT","KACHCHH",18,4,618,584,34,1258
"GUJARAT","KHEDA",12,1,2108,135,4,2260
"GUJARAT","MEHSANA",160,29,709,9002,38,9938
"GUJARAT","NARMADA",23,9,200,218,11,461
"GUJARAT","NAVSARI",0,0,199,2,1,202
"GUJARAT","PANCHMAHAL",0,0,0,14,0,14
"GUJARAT","PATAN",492,12,4449,1016,155,6124
"GUJARAT","PORBANDAR",18,4,754,0,0,776
"GUJARAT","RAJKOT",59,26,3227,3497,314,7123
"GUJARAT","SABARKANTHA",13,0,790,347,161,1311
"GUJARAT","SURAT",0,0,0,19,0,19
"GUJARAT","SURENDRANAGAR",216,62,6404,2792,828,10302
"GUJARAT","VADODARA",10,2,195,3022,9,3238
"HARYANA","AMBALA",2,11,3663,10,6,3692
"HARYANA","BHIWANI",231,9,44,1,2,287
"HARYANA","FARIDABAD",0,0,28,0,0,28
"HARYANA","FATEHABAD",3,5,2830,6,7,2851
"HARYANA","GURGAON",1,18,244,0,27,290
"HARYANA","HISSAR",0,1,328,0,1,330
"HARYANA","JHAJJAR",39,6,292,0,0,337
"HARYANA","JIND",15,75,1448,1,7,1546
"HARYANA","KAITHAL",15,12,3302,4,17,3350
"HARYANA","KARNAL",4,34,1488,845,5,2376
"HARYANA","KURUKSHETRA",21,40,3306,0,25,3392
"HARYANA","MAHENDRAGARH",652,5,29,1,58,745
"HARYANA","PANCHKULA",34,2,236,11,9,292
"HARYANA","PANIPAT",19,17,1406,0,43,1485
"HARYANA","REWARI",135,1,153,0,18,307
"HARYANA","SIRSA",16,5,2027,108,4,2160
"HARYANA","SONEPAT",32,1,536,1,19,589
"HARYANA","YAMUNANAGAR",8,2,250,10,12,282
"HIMACHAL PRADESH","Kangra",18,0,39,53,0,110
"HIMACHAL PRADESH","Kullu",0,0,2,0,0,2
"HIMACHAL PRADESH","Sirmaur",0,0,0,12,0,12
"HIMACHAL PRADESH","Solan",0,0,35,2,0,37
"HIMACHAL PRADESH","Una",0,0,60,130,0,190
"JAMMU & KASHMIR","JAMMU",1,0,13,1,0,15
"JAMMU & KASHMIR","KATHUA",0,0,5,0,0,5
"JHARKHAND","CHATRA",0,1,0,0,0,1
"JHARKHAND","DUMKA",0,0,5,0,0,5
"JHARKHAND","GARHWA",0,0,1,2,0,3
"JHARKHAND","GIRIDIH",0,0,6,1,0,7
"JHARKHAND","HAZARIBAGH",0,0,4,0,0,4
"JHARKHAND","SAHEBGANJ",0,0,5,0,0,5
"JHARKHAND","SARAIKELA",0,0,0,0,1,1
"JHARKHAND","WEST SINGHBHUM",0,0,2,0,0,2
"KARNATAKA","Bangalore",0,0,1,0,0,1
"KARNATAKA","Bangalore Rural",0,0,2,0,0,2
"KARNATAKA","Belgaum",1,0,2,1,1,5
"KARNATAKA","Bellary",0,0,1,0,0,1
"KARNATAKA","Bijapur",1,0,1,0,0,2
"KARNATAKA","Chikmagalur",2,1,0,0,1,4
"KARNATAKA","Chitradurga",0,1,0,0,0,1
"KARNATAKA","Dakshina Kannada",1,0,0,0,0,1
"KARNATAKA","Davanagere",0,0,0,2,1,3
"KARNATAKA","Dharwar",0,0,0,0,1,1
"KARNATAKA","Kolar",0,0,6,0,0,6
"KARNATAKA","Mandya",0,0,0,3,1,4
"KARNATAKA","Tumkur",0,0,0,1,0,1
"KERALA","ALAPPUZHA",0,0,0,2,0,2
"KERALA","ERANAKULAM",3,0,0,0,8,11
"KERALA","IDDUKKI",34,0,0,0,0,34
"KERALA","KANNUR",1,0,2,24,0,27
"KERALA","KASARAGODE",1,3,6,5,12,27
"KERALA","KOLLAM",0,0,2,2,1,5
"KERALA","KOTTAYAM",1,0,1,0,9,11
"KERALA","KOZHIKODE",0,0,0,1,0,1
"KERALA","MALAPPURAM",0,1,18,3,4,26
"KERALA","PALAKKAD",0,1,20,18,0,39
"KERALA","PATHANAMTHITTA",0,1,1,4,7,13
"KERALA","THIRUVANANTHAPURAM",0,0,0,0,5,5
"KERALA","THRISSUR",1,2,13,7,3,26
"MADHYA PRADESH","BALAGHAT",3,2,34,1,5,45
"MADHYA PRADESH","BARWANI",112,0,1008,458,47,1625
"MADHYA PRADESH","BETUL",75,137,1420,88,50,1770
"MADHYA PRADESH","BHIND",16,5,375,6,125,527
"MADHYA PRADESH","BHOPAL",27,50,1,129,95,302
"MADHYA PRADESH","CHHATARPUR",1,0,40,0,68,109
"MADHYA PRADESH","DAMOH",52,245,131,38,57,523
"MADHYA PRADESH","DATIA",120,3,202,0,38,363
"MADHYA PRADESH","DEWAS",62,1,1089,431,51,1634
"MADHYA PRADESH","DHAR",77,231,584,295,44,1231
"MADHYA PRADESH","GUNA",50,67,1527,6,699,2349
"MADHYA PRADESH","GWALIOR",12,0,16,0,1,29
"MADHYA PRADESH","HARDA",0,2,0,0,0,2
"MADHYA PRADESH","HOSHANGABAD",77,0,352,1,94,524
"MADHYA PRADESH","INDORE",621,23,941,124,32,1741
"MADHYA PRADESH","JABALPUR",152,0,13,0,11,176
"MADHYA PRADESH","JHABUA",61,2,330,216,113,722
"MADHYA PRADESH","KATNI",1,0,77,33,2,113
"MADHYA PRADESH","KHANDWA",83,254,604,626,193,1760
"MADHYA PRADESH","KHARGONE",80,16,1235,1712,36,3079
"MADHYA PRADESH","MANDSAUR",17,6,551,672,6,1252
"MADHYA PRADESH","MORENA",1,0,0,0,0,1
"MADHYA PRADESH","NARSINGHPUR",115,2,29,28,1,175
"MADHYA PRADESH","NEEMUCH",8,3,1233,1847,31,3122
"MADHYA PRADESH","PANNA",150,62,147,3,68,430
"MADHYA PRADESH","RAISEN",42,15,21,71,0,149
"MADHYA PRADESH","RAJGARH",58,8,477,50,109,702
"MADHYA PRADESH","RATLAM",77,73,3905,736,264,5055
"MADHYA PRADESH","REWA",12,41,980,0,68,1101
"MADHYA PRADESH","SAGAR",79,7,93,134,30,343
"MADHYA PRADESH","SATNA",78,73,1487,67,21,1726
"MADHYA PRADESH","SEHORE",69,0,22,0,0,91
"MADHYA PRADESH","SEONI",29,5,17,2,9,62
"MADHYA PRADESH","SHAHDOL",14,5,93,3,1,116
"MADHYA PRADESH","SHAJAPUR",9,8,193,24,186,420
"MADHYA PRADESH","SHEOPUR",14,20,835,0,40,909
"MADHYA PRADESH","SHIVPURI",277,38,1043,108,67,1533
"MADHYA PRADESH","SIDHI",16,3,53,0,0,72
"MADHYA PRADESH","TIKAMGARH",23,0,60,2,0,85
"MADHYA PRADESH","UJJAIN",1,0,259,28,20,308
"MADHYA PRADESH","VIDISHA",0,0,96,7,19,122
"MAHARASHTRA","AHMEDNAGAR",31,4,1339,1435,474,3283
"MAHARASHTRA","AKOLA",16,2,162,7,1,188
"MAHARASHTRA","AMRAVATI",38,5,424,99,5,571
"MAHARASHTRA","AURANGABAD",104,0,13,33,0,150
"MAHARASHTRA","BEED",439,6,114,1300,3,1862
"MAHARASHTRA","BHANDARA",0,0,6,12,19,37
"MAHARASHTRA","BULDANA",10,10,22,118,3,163
"MAHARASHTRA","CHANDRAPUR",3,0,5,14,22,44
"MAHARASHTRA","DHULE",66,8,1057,1367,585,3083
"MAHARASHTRA","GADCHIROLI",9,0,8,3,25,45
"MAHARASHTRA","GONDIYA",0,0,4,7,4,15
"MAHARASHTRA","HINGOLI",0,0,143,175,4,322
"MAHARASHTRA","JALGAON",147,962,1571,3433,398,6511
"MAHARASHTRA","JALNA",0,0,11,107,0,118
"MAHARASHTRA","KOLHAPUR",334,15,725,1189,84,2347
"MAHARASHTRA","LATUR",193,42,3212,6910,62,10419
"MAHARASHTRA","NAGPUR",1,0,24,4,10,39
"MAHARASHTRA","NANDED",11,5,555,740,10,1321
"MAHARASHTRA","NANDURBAR",1529,54,3454,956,1337,7330
"MAHARASHTRA","NASHIK",951,906,1392,532,796,4577
"MAHARASHTRA","OSMANABAD",16,29,3152,6747,291,10235
"MAHARASHTRA","PARBHANI",1,0,45,57,1,104
"MAHARASHTRA","PUNE",90,7,322,922,101,1442
"MAHARASHTRA","RAIGHAR",0,7,40,4,74,125
"MAHARASHTRA","SANGLI",448,3341,5144,2388,407,11728
"MAHARASHTRA","SATARA",3,41,315,214,0,573
"MAHARASHTRA","SINDHUDURGA",0,1,0,2,0,3
"MAHARASHTRA","SOLAPUR",386,895,3994,4369,322,9966
"MAHARASHTRA","THANE",0,1,1,17,0,19
"MAHARASHTRA","WARDHA",40,9,29,1,25,104
"MAHARASHTRA","WASHIM",8,1,7,26,35,77
"MAHARASHTRA","YAVATMAL",172,2,224,13,11,422
"MEGHALAYA","WEST GARO HILLS",0,0,7,0,1,8
"NAGALAND","DIMAPUR",0,1,1,0,1,3
"ORISSA","ANGUL",0,0,2,0,0,2
"ORISSA","BALASORE",43,14,1113,304,162,1636
"ORISSA","BARGARH",1,0,67,1,0,69
"ORISSA","BHADRAK",35,5,411,97,16,564
"ORISSA","BOLANGIR",1,0,31,0,1,33
"ORISSA","CUTTACK",20,3,97,100,75,295
"ORISSA","DEOGARH",0,0,5,0,0,5
"ORISSA","DHENKANAL",1,0,1,1,2,5
"ORISSA","GAJAPATI",1,0,1,0,0,2
"ORISSA","GANJAM",6,4,74,6,1,91
"ORISSA","JAGATSINGHPUR",7,0,177,76,2,262
"ORISSA","JAJAPUR",35,7,400,158,99,699
"ORISSA","JHARSUGUDA",4,2,133,2,5,146
"ORISSA","KALAHANDI",0,0,10,0,3,13
"ORISSA","KENDRAPARA",2,0,54,2,2,60
"ORISSA","KEONJHAR",2,2,11,0,31,46
"ORISSA","KHURDA",2,0,23,14,2,41
"ORISSA","KORAPUT",0,0,1,1,0,2
"ORISSA","MALKANAGIRI",0,1,6,0,1,8
"ORISSA","MAYURBHANJA",7,0,347,36,15,405
"ORISSA","NAWARANGAPUR",0,0,5,0,1,6
"ORISSA","NAYAGARH",1,0,8,0,1,10
"ORISSA","NUAPADA",0,0,3,1,1,5
"ORISSA","PURI",9,0,58,26,3,96
"ORISSA","RAYAGADA",0,0,9,2,1,12
"ORISSA","SAMBALPUR",0,0,30,2,1,33
"ORISSA","SONEPUR",0,0,3,0,0,3
"ORISSA","SUNDARGARH",5,2,36,0,0,43
"PONDICHERRY","KARAIKAL",3,6,10,0,0,19
"PONDICHERRY","PONDICHERRY",0,0,256,53,0,309
"PUNJAB","AMRITSER",0,0,2,2,0,4
"PUNJAB","GURDASPUR",2,11,1917,78,0,2008
"PUNJAB","HOSHIARPUR",46,13,1127,639,1,1826
"PUNJAB","KAPURTHALA",0,0,14,0,0,14
"PUNJAB","LUDHIANA",5,0,275,46,8,334
"PUNJAB","MOGA",0,0,86,15,0,101
"PUNJAB","NAWANSHAHAR",7,1,259,180,0,447
"PUNJAB","PATIALA",9,30,2086,79,1,2205
"PUNJAB","ROPAR",15,10,481,386,1,893
"PUNJAB","SANGRUR",3,11,2111,33,0,2158
"RAJASTHAN","AJMER",0,0,44,25,2,71
"RAJASTHAN","ALWAR",0,1,25,0,2,28
"RAJASTHAN","BANSWARA",0,0,164,30,0,194
"RAJASTHAN","BARAN",248,96,8419,20,502,9285
"RAJASTHAN","BARMER",402,2,43,7,15,469
"RAJASTHAN","BHARATPUR",5,40,634,184,124,987
"RAJASTHAN","BHILWARA",4,1,227,10,5,247
"RAJASTHAN","BIKANER",2280,151,52,0,4,2487
"RAJASTHAN","BUNDI",67,38,3516,52,330,4003
"RAJASTHAN","CHITTORGARH",122,25,4285,2096,920,7448
"RAJASTHAN","CHURU",1182,12,2,0,0,1196
"RAJASTHAN","DAUSA",0,0,15,0,0,15
"RAJASTHAN","DUNGARPUR",0,0,45,18,14,77
"RAJASTHAN","JAIPUR",68,0,70,3,0,141
"RAJASTHAN","JAISALMER",809,11,82,0,0,902
"RAJASTHAN","JALORE",412,35,556,59,12,1074
"RAJASTHAN","JHALAWAR",4,0,137,404,0,545
"RAJASTHAN","JHUNJHUNU",7,0,0,0,0,7
"RAJASTHAN","JODHPUR",1135,144,9919,2236,229,13663
"RAJASTHAN","KAROLI",0,2,309,124,0,435
"RAJASTHAN","KOTA",0,6,1751,9,89,1855
"RAJASTHAN","NAGAUR",1600,280,6132,517,531,9060
"RAJASTHAN","PALI",8,0,430,164,3,605
"RAJASTHAN","RAJSAMAND",3,0,85,36,6,130
"RAJASTHAN","SAWAI MADHOPUR",2,19,778,0,241,1040
"RAJASTHAN","SIKAR",92,3,1,0,9,105
"RAJASTHAN","SIROHI",0,1,72,0,0,73
"RAJASTHAN","TONK",3,0,246,0,7,256
"RAJASTHAN","UDAIPUR",1,4,273,57,31,366
"TAMIL NADU","COIMBATORE",1514,2698,14993,798,1970,21973
"TAMIL NADU","CUDDALORE",158,11,3012,378,231,3790
"TAMIL NADU","DHARMAPURI",95,79,1003,679,168,2024
"TAMIL NADU","DINDIGUL",121,95,2205,429,107,2957
"TAMIL NADU","ERODE",301,67,5040,1038,263,6709
"TAMIL NADU","KANCHEEPURAM",88,0,357,35,2,482
"TAMIL NADU","KANYAKUMARI",0,0,310,0,2,312
"TAMIL NADU","KARUR",85,44,711,19,72,931
"TAMIL NADU","MADURAI",24,31,260,85,7,407
"TAMIL NADU","NAMAKKAL",21,35,3000,173,531,3760
"TAMIL NADU","NILGIRIS",0,0,1,0,0,1
"TAMIL NADU","PERAMBALUR",54,17,1924,561,140,2696
"TAMIL NADU","PUDUKKOTTAI",77,50,6983,569,58,7737
"TAMIL NADU","RAMANATHAPURAM",9,1,502,35,31,578
"TAMIL NADU","SALEM",2053,12,3408,140,113,5726
"TAMIL NADU","SIVAGANGA",5,10,386,91,24,516
"TAMIL NADU","THANJAVUR",332,51,14203,231,229,15046
"TAMIL NADU","THENI",319,55,2040,155,4,2573
"TAMIL NADU","THIRUVALLUR",244,1,83,4,69,401
"TAMIL NADU","THIRUVARUR",6,14,2289,229,1,2539
"TAMIL NADU","TIRUCHIRAPPALLI",17,3,257,35,16,328
"TAMIL NADU","TIRUNELVELI",41,23,434,68,30,596
"TAMIL NADU","TIRUVANNAMALAI",2,0,24,1,1,28
"TAMIL NADU","TUTICORIN DISTRICT",3,6,58,30,0,97
"TAMIL NADU","VELLORE",4,0,259,28,17,308
"TAMIL NADU","VILLUPPURAM",49,2,1001,191,2,1245
"TAMIL NADU","VIRUDHUNAGAR",11,5,199,13,22,250
"TRIPURA","DHALAI",0,0,0,3,0,3
"TRIPURA","NORTH TRIPURA",0,0,2,9,1,12
"TRIPURA","SOUTH TRIPURA",0,0,1,22,9,32
"TRIPURA","WEST TRIPURA",1,4,51,61,4,121
"UTTAR PRADESH","AGRA",6,2,582,122,57,769
"UTTAR PRADESH","ALIGARH",60,4,492,65,2,623
"UTTAR PRADESH","ALLAHABAD",17,12,916,189,1,1135
"UTTAR PRADESH","AMBEDAKAR NAGAR",8,0,309,78,0,395
"UTTAR PRADESH","AURAIYA",0,0,189,283,0,472
"UTTAR PRADESH","AZAMGARH",10,0,123,163,0,296
"UTTAR PRADESH","BAGHPAT",1,1,351,1,18,372
"UTTAR PRADESH","BAHARAICH",4,6,131,257,0,398
"UTTAR PRADESH","BALLIA",45,13,481,191,0,730
"UTTAR PRADESH","BALRAMPUR",2,108,117,49,0,276
"UTTAR PRADESH","BANDA",53,2,1253,328,4,1640
"UTTAR PRADESH","BARABANKI",8,0,117,73,0,198
"UTTAR PRADESH","BAREILLY",10,4,454,266,16,750
"UTTAR PRADESH","BASTI",1,2,435,47,0,485
"UTTAR PRADESH","BIJNOR",0,0,636,0,0,636
"UTTAR PRADESH","BUDAUN",17,6,668,221,6,918
"UTTAR PRADESH","BULAND SAHAR",8,1,275,40,3,327
"UTTAR PRADESH","CHANDAULI",0,0,191,34,0,225
"UTTAR PRADESH","CHITRAKOOT",10,1,90,6,37,144
"UTTAR PRADESH","DEORIA",1,9,646,195,3,854
"UTTAR PRADESH","ETAH",3,1,642,0,0,646
"UTTAR PRADESH","ETAWAH",0,0,126,391,0,517
"UTTAR PRADESH","FAIZABAD",13,0,432,115,0,560
"UTTAR PRADESH","FARRUKHABAD",11,0,155,125,0,291
"UTTAR PRADESH","FATEHPUR",23,20,504,59,12,618
"UTTAR PRADESH","FIROZABAD",4,3,234,21,1,263
"UTTAR PRADESH","GAUTAM BUDHA NAGAR",2,0,86,44,0,132
"UTTAR PRADESH","GHAZIABAD",4,1,177,20,0,202
"UTTAR PRADESH","GHAZIPUR",24,0,374,369,0,767
"UTTAR PRADESH","GONDA",3,0,299,131,0,433
"UTTAR PRADESH","GORAKHPUR",12,6,623,338,8,987
"UTTAR PRADESH","HAMIRPUR",12,6,568,183,8,777
"UTTAR PRADESH","HARDOI",0,0,551,0,0,551
"UTTAR PRADESH","HATHRAS",2,0,119,11,0,132
"UTTAR PRADESH","JALAUN",85,9,1350,149,20,1613
"UTTAR PRADESH","JAUNPUR",0,0,395,120,0,515
"UTTAR PRADESH","JHANSI",25,22,218,24,29,318
"UTTAR PRADESH","JYOTIBA PHULENAGAR",8,1,287,91,0,387
"UTTAR PRADESH","KANNAUJ",10,0,116,85,0,211
"UTTAR PRADESH","KANPUR DEHAT",31,18,1031,100,46,1226
"UTTAR PRADESH","KANPUR NAGAR",28,3,836,51,1,919
"UTTAR PRADESH","KAUSHAMBI",0,9,203,71,3,286
"UTTAR PRADESH","KHERI",44,9,454,248,0,755
"UTTAR PRADESH","KUSHINAGAR",0,2,130,10,0,142
"UTTAR PRADESH","LALITPUR",0,0,72,12,0,84
"UTTAR PRADESH","LUCKNOW",11,2,297,60,11,381
"UTTAR PRADESH","MAHARAJ GANJ",3,2,86,124,1,216
"UTTAR PRADESH","MAHOBA",0,0,28,0,0,28
"UTTAR PRADESH","MAINPURI",2,0,110,213,2,327
"UTTAR PRADESH","MATHURA",0,0,38,0,0,38
"UTTAR PRADESH","MAU",10,0,155,108,0,273
"UTTAR PRADESH","MEERUT",0,2,333,8,9,352
"UTTAR PRADESH","MIRZAPUR",8,2,330,142,0,482
"UTTAR PRADESH","MORADABAD",50,19,1020,153,0,1242
"UTTAR PRADESH","MUZZAFARNAGAR",0,0,439,52,12,503
"UTTAR PRADESH","PILIBHIT",1,2,32,91,0,126
"UTTAR PRADESH","PRATAPGARH",3,0,72,20,0,95
"UTTAR PRADESH","RAEBARELI",12,0,192,186,0,390
"UTTAR PRADESH","RAMPUR",8,5,677,77,0,767
"UTTAR PRADESH","SAHARANPUR",2,2,523,72,0,599
"UTTAR PRADESH","SANT KABIR NAGAR",8,7,231,77,35,358
"UTTAR PRADESH","SANT RAVI DAS NAGAR",3,2,432,46,0,483
"UTTAR PRADESH","SHAHJAHANPUR",0,0,458,0,0,458
"UTTAR PRADESH","SHRAWASTI",1,1,172,46,0,220
"UTTAR PRADESH","SIDDHARTH NAGAR",3,0,87,205,1,296
"UTTAR PRADESH","SITAPUR",0,0,699,0,0,699
"UTTAR PRADESH","SONBHADRA",2,0,23,5,0,30
"UTTAR PRADESH","SULTANPUR",46,10,469,254,0,779
"UTTAR PRADESH","UNNAO",1,0,137,30,0,168
"UTTAR PRADESH","VARANASI",12,4,646,134,4,800
"UTTARANCHAL","CHAMPAWAT",0,0,6,0,0,6
"UTTARANCHAL","DEHRA DUN",0,0,68,11,0,79
"UTTARANCHAL","HARIDWAR",1,0,187,26,0,214
"UTTARANCHAL","NAINITAL",0,5,114,48,2,169
"UTTARANCHAL","PAURI",0,0,12,3,0,15
"UTTARANCHAL","UDHAM SINGH NAGAR",3,15,281,100,1,400
"WEST BENGAL","BANKURA",0,0,11,149,0,160
"WEST BENGAL","BIRBHUM",0,0,11,114,0,125
"WEST BENGAL","BURDWAN",0,0,48,578,0,626
"WEST BENGAL","COOCHBEHAR",0,0,3,63,0,66
"WEST BENGAL","DAKSHIN DINAJPUR",0,0,9,141,0,150
"WEST BENGAL","DARJEELING",0,0,0,38,0,38
"WEST BENGAL","HAORA",0,0,8,175,0,183
"WEST BENGAL","HOOGHLY",0,0,45,482,0,527
"WEST BENGAL","JALPAIGURI",0,0,29,206,0,235
"WEST BENGAL","MALDA",0,0,42,331,0,373
"WEST BENGAL","MIDNAPORE",0,0,255,517,1,773
"WEST BENGAL","MURSHIDABAD",0,0,85,503,0,588
"WEST BENGAL","NADIA",0,0,120,637,0,757
"WEST BENGAL","NORTH 24 PARGANAS",0,0,82,245,0,327
"WEST BENGAL","SOUTH 24 PARGANAS",0,0,2,27,0,29
"WEST BENGAL","UTTAR DINAJPUR",0,0,9,173,0,182
